"filename", "language", "Rust", "TOML", "Markdown", "comment", "blank", "total"
"c:\Users\jaeds\projetos\hydraulic-telemetry-embedded\.cargo\config.toml", "TOML", 0, 11, 0, 0, 4, 15
"c:\Users\jaeds\projetos\hydraulic-telemetry-embedded\Cargo.lock", "TOML", 0, 1328, 0, 2, 158, 1488
"c:\Users\jaeds\projetos\hydraulic-telemetry-embedded\Cargo.toml", "TOML", 0, 54, 0, 1, 2, 57
"c:\Users\jaeds\projetos\hydraulic-telemetry-embedded\README.md", "Markdown", 0, 0, 5, 0, 0, 5
"c:\Users\jaeds\projetos\hydraulic-telemetry-embedded\rust-toolchain.toml", "TOML", 0, 2, 0, 0, 1, 3
"c:\Users\jaeds\projetos\hydraulic-telemetry-embedded\src\charger_sepic.rs", "Rust", 67, 0, 0, 0, 9, 76
"c:\Users\jaeds\projetos\hydraulic-telemetry-embedded\src\device_state.rs", "Rust", 18, 0, 0, 0, 6, 24
"c:\Users\jaeds\projetos\hydraulic-telemetry-embedded\src\digital_input.rs", "Rust", 94, 0, 0, 0, 13, 107
"c:\Users\jaeds\projetos\hydraulic-telemetry-embedded\src\i2c_adc.rs", "Rust", 69, 0, 0, 0, 13, 82
"c:\Users\jaeds\projetos\hydraulic-telemetry-embedded\src\int_adc.rs", "Rust", 72, 0, 0, 0, 8, 80
"c:\Users\jaeds\projetos\hydraulic-telemetry-embedded\src\led_output.rs", "Rust", 58, 0, 0, 2, 9, 69
"c:\Users\jaeds\projetos\hydraulic-telemetry-embedded\src\main.rs", "Rust", 162, 0, 0, 7, 27, 196
"c:\Users\jaeds\projetos\hydraulic-telemetry-embedded\src\mqtt.rs", "Rust", 91, 0, 0, 5, 11, 107
"c:\Users\jaeds\projetos\hydraulic-telemetry-embedded\src\pressure_boost.rs", "Rust", 45, 0, 0, 0, 7, 52
"c:\Users\jaeds\projetos\hydraulic-telemetry-embedded\src\pulse_counter.rs", "Rust", 20, 0, 0, 0, 5, 25
"c:\Users\jaeds\projetos\hydraulic-telemetry-embedded\src\temperature.rs", "Rust", 48, 0, 0, 5, 5, 58
"c:\Users\jaeds\projetos\hydraulic-telemetry-embedded\src\wifi.rs", "Rust", 44, 0, 0, 1, 4, 49
"Total", "-", 788, 1395, 5, 23, 282, 2493